145 146 146 146 146 146 146 146 146 146 146 146 146 146 146 146 146 146 146 146 146 146 146 146 146 146 146 146 146 146 146 146 147
144 155 157 158 157 157 157 157 157 157 157 157 157 157 157 157 157 157 157 157 157 157 157 157 157 157 158 162 162 155 157 158 149
144 153 154 155 154 154 154 154 154 154 154 154 154 154 154 154 154 154 154 154 154 154 154 154 154 154 155 162 162 153 154 155 149
144 150 160 152 154 154 155 151 151 151 151 151 151 151 151 151 151 151 151 151 151 151 151 151 151 151 152 162 162 150 159 152 149
144 153 154 154 154 154 155 162 162 162 162 162 162 162 162 162 162 162 162 162 162 162 162 162 162 162 162 162 162 153 154 155 149
144 153 154 155 151 151 152 162 162 162 162 162 162 162 155 157 158 162 162 162 162 162 162 162 162 162 162 162 162 153 154 155 149
144 153 154 155 162 162 162 162 162 162 162 162 162 162 153 154 155 162 162 162 162 155 157 157 157 157 157 157 157 161 154 155 149
144 153 154 155 162 162 162 162 162 162 162 162 162 162 153 154 155 162 162 162 162 153 154 154 154 154 154 154 154 154 154 155 149
144 153 154 155 162 162 162 162 162 162 162 162 162 162 153 154 155 162 162 162 162 153 154 155 151 151 151 153 154 155 151 152 149
144 153 154 155 162 162 162 162 162 162 162 162 162 162 153 154 155 162 162 162 162 153 154 155 162 162 162 153 154 155 162 162 149
144 153 154 155 162 162 162 162 162 162 162 162 162 162 153 154 155 162 162 162 162 153 154 155 162 162 162 153 154 155 162 162 149
144 153 154 55 157 157 157 157 157 157 157 157 157 157 161 154 155 162 162 162 162 153 154 155 162 162 162 153 154 155 162 162 149
144 153 154 154 154 154 154 154 154 154 154 154 154 154 154 154 155 162 162 162 162 153 154 155 162 162 162 153 154 155 162 162 149
144 152 151 151 151 151 153 154 155 151 151 151 151 151 153 154 155 162 162 162 162 153 154 155 162 162 162 153 154 155 162 162 149
144 162 162 162 162 162 153 154 155 162 162 162 162 162 152 151 152 162 162 162 162 153 154 155 162 162 162 153 154 155 162 162 149
144 162 162 162 162 162 153 154 155 162 162 162 162 162 162 162 162 162 162 162 162 153 154 155 162 162 162 153 154 155 162 162 149
144 162 162 162 162 162 153 154 155 162 162 162 162 162 162 162 162 162 162 162 162 153 154 155 162 162 162 153 154 155 162 162 149
144 162 162 162 162 162 153 154 155 162 162 162 162 162 162 162 162 162 162 162 162 153 154 155 162 162 162 153 154 155 162 162 149
144 162 162 162 162 162 153 154 155 162 162 162 162 162 162 162 155 157 157 157 157 161 154 163 157 158 162 153 154 155 162 162 149
144 162 162 162 162 162 153 154 155 162 162 162 162 162 162 162 153 154 154 154 154 154 154 154 154 155 162 153 154 155 162 162 149
144 162 162 162 162 162 153 154 155 162 162 162 162 162 162 162 153 154 154 154 154 154 154 154 154 155 162 153 154 155 162 162 149
144 162 162 155 157 157 54 154 155 162 162 155 157 157 157 157 161 154 154 154 154 154 154 154 154 155 162 153 154 155 162 162 149
144 162 162 153 154 155 151 151 152 162 162 153 154 154 154 154 154 154 154 154 154 154 154 154 154 155 162 153 154 155 162 162 149
144 162 162 153 154 155 162 162 162 162 162 153 154 155 151 151 153 154 154 154 154 154 154 154 154 155 162 153 154 155 162 162 149
144 162 162 153 154 55 157 157 157 157 157 161 154 155 162 162 150 151 151 153 154 155 151 151 151 152 162 152 151 152 162 162 149
144 162 162 153 154 154 154 154 154 154 154 154 154 155 162 162 162 162 162 153 154 155 162 162 162 162 162 162 162 162 162 162 149
144 162 162 152 151 151 151 151 151 151 151 151 151 152 162 162 162 162 162 153 154 155 162 162 162 162 162 162 162 162 162 162 149
144 162 162 162 162 162 162 162 162 162 162 162 162 162 162 162 162 162 162 153 154 155 162 162 162 162 162 162 162 162 162 162 149
144 162 162 162 162 162 162 162 162 162 162 162 162 162 162 162 162 162 162 153 154 155 162 162 162 162 162 162 162 162 162 162 149
144 162 162 162 162 162 162 162 162 156 157 157 157 157 157 157 157 157 157 161 154 155 162 162 162 162 162 162 162 162 162 162 149
144 162 162 162 162 162 162 162 162 155 154 154 154 154 154 154 154 154 154 154 154 155 162 162 162 162 162 162 162 162 162 162 149
144 162 162 162 162 162 162 162 162 150 151 151 151 151 151 151 151 151 151 151 151 151 162 162 162 162 162 162 162 162 162 162 149
141 142 142 142 142 142 142 142 142 142 142 142 142 142 142 142 142 142 142 142 142 142 142 142 142 142 142 142 142 142 142 142 143

