8 8 8 8 8 8 8 90 90 90 8 8 8 8 8 8 8 8 8 8 8 8 8 8 8 8 8 8 8 8 8 8 8 8 8 8 8 8 8 8 8 8 8 8 8 8 8 8 8 8 
8 8 8 8 8 8 8 90 90 90 8 8 8 8 8 8 8 8 8 8 8 8 8 8 8 8 8 8 8 8 8 8 8 8 8 8 8 8 8 8 8 8 8 8 8 8 8 8 8 8 
8 8 8 8 8 8 8 8 90 8 8 8 8 8 8 8 8 8 8 8 8 8 8 8 8 8 8 8 8 8 8 8 8 8 8 8 8 8 8 8 8 8 8 8 8 8 8 8 8 8 
8 8 8 8 8 8 90 90 90 90 90 8 8 8 8 8 8 8 8 8 8 8 90 90 90 90 8 8 8 8 8 8 8 8 8 8 8 8 8 8 8 8 8 8 8 8 8 8 8 8 
8 8 8 8 8 8 90 90 90 90 90 8 8 8 8 8 8 8 8 8 8 8 90 90 90 90 8 8 8 8 8 8 8 8 8 8 8 8 8 8 8 90 90 8 8 8 8 8 8 8 
8 8 8 8 8 8 8 8 90 8 8 8 8 8 8 8 8 8 8 8 8 8 90 90 90 90 8 8 8 8 8 8 8 8 8 8 8 8 8 90 90 90 90 90 90 8 8 8 8 8 
8 8 8 8 8 8 8 8 90 8 8 8 92 52 68 84 8 8 8 8 8 8 90 90 90 90 90 90 90 90 90 90 90 90 90 8 8 8 8 90 90 90 90 90 90 8 8 8 8 8 
8 8 8 8 8 8 8 8 90 8 8 8 76 60 100 44 8 8 90 90 90 90 90 90 90 90 90 90 90 90 90 90 90 90 90 8 8 8 8 90 90 90 90 90 90 8 8 8 8 8 
8 8 8 8 8 8 8 8 90 8 8 8 32 100 44 76 8 8 90 8 8 8 90 90 90 90 8 8 8 8 8 8 8 90 90 8 8 13 14 15 8 90 90 8 8 8 8 8 8 8 
8 8 8 8 8 8 8 8 90 8 8 8 8 8 8 8 8 8 90 8 8 8 8 8 8 8 8 8 8 8 8 8 8 90 90 8 8 16 11 17 8 90 90 8 8 8 8 8 8 8 
8 8 8 8 8 8 8 8 90 8 8 8 8 8 8 8 8 8 90 8 8 8 8 8 8 8 8 8 90 90 90 90 8 90 90 8 8 16 11 17 8 90 90 8 8 8 8 8 8 8 
8 8 8 8 8 8 8 8 90 8 8 8 90 90 90 90 8 8 90 8 8 8 8 8 8 8 8 8 90 90 90 90 8 90 90 8 8 18 19 20 8 90 90 8 8 8 8 8 8 8 
8 8 8 8 8 8 8 8 90 8 8 8 90 90 90 90 90 90 90 8 90 90 90 90 90 90 90 90 90 90 90 90 90 90 90 8 8 8 8 8 8 90 90 8 8 8 8 8 8 8 
8 8 8 8 8 8 8 8 90 90 90 90 90 90 90 90 90 90 90 8 90 90 90 90 90 90 90 90 90 90 90 90 8 8 8 8 8 8 90 90 90 90 90 8 8 8 8 8 8 8 
8 8 8 8 8 8 8 8 8 8 8 8 90 90 90 90 8 8 8 8 90 8 8 8 8 8 8 8 90 90 90 90 8 8 8 8 8 8 90 90 90 90 90 8 8 8 8 8 8 8 
8 8 8 8 8 8 8 8 8 8 8 8 90 90 90 90 8 8 8 8 90 8 8 8 8 8 8 8 90 90 90 90 8 8 8 8 8 8 90 90 8 8 8 8 8 8 8 8 8 8 
8 8 8 8 8 8 8 8 8 8 8 8 8 8 8 8 8 8 8 8 90 8 8 8 8 8 8 8 8 8 8 8 8 8 8 8 8 8 90 90 8 8 8 8 8 8 8 8 8 8 
8 8 8 8 8 8 8 8 8 8 8 8 8 8 8 8 8 8 8 8 90 8 8 8 8 68 92 44 68 68 44 92 44 92 68 44 8 8 90 90 8 8 8 8 8 8 8 8 8 8 
8 8 8 8 8 8 29 30 30 30 31 8 8 8 8 8 8 90 90 90 90 90 90 8 8 44 13 14 14 14 14 14 14 14 15 68 8 8 90 90 8 8 8 8 8 8 8 8 8 8 
8 8 8 8 8 8 41 52 68 52 43 8 8 8 8 8 8 90 90 90 90 90 90 8 8 68 16 11 11 11 11 11 11 11 17 44 8 8 90 90 8 8 8 8 8 8 8 8 8 8 
8 8 8 8 8 8 49 50 50 50 51 8 8 8 8 8 8 90 90 90 90 90 90 8 8 44 16 11 11 11 11 11 11 11 17 8 8 8 90 90 8 8 8 8 8 8 8 8 8 8 
8 8 8 8 8 8 8 8 8 8 8 8 8 8 8 8 8 90 90 90 90 90 90 8 13 14 25 11 11 11 11 11 11 11 17 8 90 90 90 90 90 90 8 8 8 8 8 8 8 8 
8 8 8 8 8 8 8 8 8 8 8 8 8 8 8 8 8 8 8 90 90 8 8 8 16 8 16 11 11 11 11 11 11 11 17 8 90 90 90 90 90 90 8 8 8 8 8 8 8 8 
8 8 8 8 8 29 30 30 31 8 8 8 8 90 90 90 90 90 90 90 90 8 8 8 16 8 16 11 11 11 11 11 11 11 17 8 90 90 90 90 90 90 8 8 8 8 8 8 8 8 
8 8 8 8 8 41 76 84 43 8 8 8 8 90 90 90 90 90 90 90 90 8 8 8 18 19 19 19 22 11 11 11 11 11 17 8 90 90 90 90 90 90 8 8 8 8 8 8 8 8 
8 8 8 8 8 41 84 44 43 8 8 8 90 90 90 8 8 8 8 8 8 8 8 8 8 8 8 8 18 19 19 19 19 19 20 8 8 8 90 8 8 8 8 8 8 8 8 8 8 8 
8 8 8 8 8 49 50 50 51 8 8 8 90 90 90 8 8 8 8 90 90 90 90 90 90 8 8 8 8 8 8 8 8 8 8 8 8 8 90 8 8 8 8 8 8 8 8 8 8 8 
8 8 8 8 8 8 8 8 8 8 8 8 90 8 8 8 8 8 8 90 90 90 90 90 90 90 90 90 90 90 90 90 90 90 90 90 90 90 90 8 8 8 8 8 8 8 8 8 8 8 
8 8 8 8 8 8 8 8 8 8 8 8 90 8 8 8 8 8 8 90 90 90 90 90 90 90 90 90 90 90 90 90 90 90 90 90 90 90 90 8 8 8 8 8 8 8 8 8 8 8 
8 8 8 8 8 8 8 8 8 8 8 8 90 8 8 8 8 8 8 90 90 90 90 90 90 8 8 8 8 8 8 8 8 8 8 8 8 8 8 8 8 8 8 8 8 8 8 8 8 8 
8 8 8 8 8 8 8 8 8 8 90 90 90 90 8 8 8 8 8 8 8 8 90 8 8 8 44 68 44 92 8 8 8 8 8 8 8 8 8 76 52 84 68 76 52 8 8 8 8 8 
8 8 8 8 8 8 8 8 8 90 90 90 90 90 90 8 8 8 8 8 8 8 90 8 92 92 68 44 68 44 8 90 90 90 90 8 8 8 8 52 76 84 76 52 76 8 8 8 8 8 
8 8 8 8 8 8 8 8 8 90 90 90 90 90 90 8 8 8 8 8 8 8 90 8 8 8 8 8 8 8 8 90 90 90 90 8 8 8 8 68 100 100 100 68 100 8 8 8 8 8 
8 8 8 8 8 8 8 8 8 90 90 90 90 90 90 8 8 8 8 8 8 8 90 90 90 90 90 90 90 90 90 90 90 90 90 8 8 8 8 8 8 8 8 8 8 8 8 8 8 8 
8 8 8 8 8 8 8 8 8 8 90 90 90 90 8 8 8 8 8 8 8 8 90 90 90 90 90 90 90 90 90 90 90 90 90 90 90 90 90 90 90 90 8 8 8 8 8 8 8 8 
8 8 8 8 8 8 8 8 8 8 8 90 90 8 8 8 8 8 8 8 8 8 8 8 8 8 8 8 8 8 8 90 90 90 90 8 8 8 8 8 90 90 8 8 8 8 8 8 8 8 
8 8 8 8 8 8 8 8 8 8 8 90 90 8 8 8 8 8 8 90 90 90 90 8 76 100 52 76 92 76 8 90 90 90 90 8 8 8 8 8 90 90 8 8 8 8 8 8 8 8 
8 8 8 8 8 8 8 8 8 8 8 90 90 8 8 8 8 8 8 90 90 90 90 8 76 76 52 52 92 92 8 8 8 8 8 8 8 8 8 8 90 90 8 8 8 8 8 8 8 8 
8 8 8 8 8 8 8 8 8 8 8 90 90 90 90 90 90 90 90 90 90 90 90 8 76 100 76 52 100 76 8 8 8 8 8 8 8 8 8 8 90 90 8 8 8 8 8 8 8 8 
8 8 8 8 8 8 8 8 8 8 8 8 8 8 8 8 8 8 8 90 90 90 90 8 8 8 8 8 8 8 8 8 73 90 90 90 8 8 8 8 90 90 8 8 8 8 8 8 8 8 
8 8 8 8 8 8 8 8 8 8 8 13 14 14 14 14 15 8 8 90 90 90 90 90 90 90 90 90 90 90 90 90 73 90 90 90 8 8 8 8 90 90 8 8 8 8 8 8 8 8 
8 8 8 8 8 8 8 8 13 14 14 25 19 19 19 22 17 8 8 90 90 90 90 8 8 8 8 8 8 8 8 8 73 90 90 90 90 90 90 90 90 90 8 8 8 8 8 8 8 8 
8 8 8 8 8 8 8 8 18 19 19 20 8 8 8 16 17 8 8 8 8 8 8 8 8 29 30 30 30 30 31 8 73 90 90 90 90 90 90 90 90 90 8 8 8 8 8 8 8 8 
8 8 8 8 8 8 8 8 8 8 8 8 8 8 8 16 24 14 14 14 15 8 8 8 8 41 52 76 84 52 43 8 73 90 90 90 8 8 8 8 8 8 8 8 8 8 8 8 8 8 
8 8 8 8 8 8 8 8 8 8 8 8 8 8 8 18 19 19 19 19 20 8 8 8 8 41 52 92 76 100 43 8 73 90 90 90 8 8 8 8 8 8 8 8 8 8 8 8 8 8 
8 8 8 8 8 8 8 8 8 8 8 8 8 8 8 8 8 8 8 8 8 8 8 8 8 49 50 50 50 50 51 8 8 8 8 8 8 8 8 8 8 8 8 8 8 8 8 8 8 8 
8 8 8 8 8 8 8 8 8 8 8 8 8 8 8 8 8 8 8 8 8 8 8 8 8 8 8 8 8 8 8 8 8 8 8 8 8 8 8 8 8 8 8 8 8 8 8 8 8 8 
8 8 8 8 8 8 8 8 8 8 8 8 8 8 8 8 8 8 8 8 8 8 8 8 8 8 8 8 8 8 8 8 8 8 8 8 8 8 8 8 8 8 8 8 8 8 8 8 8 8 
8 8 8 8 8 8 8 8 8 8 8 8 8 8 8 8 8 8 8 8 8 8 8 8 8 8 8 8 8 8 8 8 8 8 8 8 8 8 8 8 8 8 8 8 8 8 8 8 8 8 
8 8 8 8 8 8 8 8 8 8 8 8 8 8 8 8 8 8 8 8 8 8 8 8 8 8 8 8 8 8 8 8 8 8 8 8 8 8 8 8 8 8 8 8 8 8 8 8 8 8 
