8 8 8 8 8 8 8 1 1 1 8 8 8 8 8 8 8 8 8 8 8 8 8 8 8 8 8 8 8 8 8 8 8 8 8 8 8 8 8 8 8 8 8 8 8 8 8 8 8 8 
8 8 8 8 8 8 8 1 1 1 8 8 8 8 8 8 8 8 8 8 8 8 8 8 8 8 8 8 8 8 8 8 8 8 8 8 8 8 8 8 8 8 8 8 8 8 8 8 8 8 
8 8 8 8 8 8 8 1 1 1 8 8 8 8 8 8 8 8 8 8 8 8 8 8 8 8 8 8 8 8 8 8 8 8 8 8 8 8 8 8 8 8 8 8 8 8 8 8 8 8 
8 8 8 8 8 8 1 1 1 1 1 8 8 8 8 8 8 8 8 8 8 8 8 8 8 8 8 8 8 8 8 8 8 8 8 8 8 8 8 8 8 8 8 8 8 8 8 8 8 8 
8 8 8 8 8 8 1 1 1 1 1 75 75 75 75 75 75 75 75 75 75 75 75 75 75 75 75 75 75 75 75 75 75 75 75 8 8 8 8 8 8 8 8 8 8 8 8 8 8 8 
8 8 8 8 8 75 124 1 1 1 116 75 75 135 136 75 75 75 75 75 75 75 75 75 13 14 14 14 14 14 14 15 68 75 75 8 8 8 8 8 8 8 8 8 8 8 8 8 8 8 
8 8 8 8 8 75 75 1 1 1 75 75 41 139 140 43 75 72 32 135 136 76 72 75 18 19 19 22 11 11 11 17 44 75 75 75 8 8 8 8 8 8 8 8 8 8 8 8 8 8 
8 8 8 8 8 75 75 1 1 1 75 75 41 75 75 43 75 72 100 139 140 32 72 75 70 84 32 16 11 11 11 17 70 75 75 75 8 8 8 8 8 8 8 8 8 8 8 8 8 8 
8 8 8 8 8 75 75 1 1 1 75 75 49 50 50 51 75 72 68 75 75 92 72 75 75 75 84 16 11 11 11 17 92 75 75 75 8 8 8 8 8 8 8 8 8 8 8 8 8 8 
8 8 8 8 8 75 75 1 1 1 75 75 75 75 75 75 75 55 66 66 66 66 56 75 75 75 68 18 19 19 19 20 68 75 75 75 8 8 8 8 8 8 8 8 8 8 8 8 8 8 
8 8 8 8 8 75 75 1 1 1 75 75 75 75 75 75 75 75 75 75 75 75 75 75 75 75 75 92 52 70 84 70 75 75 75 75 8 8 8 8 8 8 8 8 8 8 8 8 8 8 
8 8 8 8 8 75 75 1 1 1 75 75 75 76 75 75 75 75 75 1 1 1 1 1 1 1 1 1 1 1 1 1 1 75 75 75 8 8 8 8 8 8 8 8 8 8 8 8 8 8 
8 8 8 8 8 75 75 1 1 1 75 75 75 75 69 75 75 75 75 47 48 1 1 1 1 1 1 1 1 1 1 1 1 75 75 75 8 8 8 8 8 8 8 8 8 8 8 8 8 8 
8 8 8 8 8 75 75 1 1 1 75 75 75 69 75 75 75 75 75 55 56 1 1 1 1 1 1 1 1 1 1 1 1 75 75 75 8 8 8 8 8 8 8 8 8 8 8 8 8 8 
8 8 8 8 8 75 75 1 1 1 75 75 75 75 75 75 75 75 75 1 1 1 75 70 70 75 75 75 75 75 75 75 75 75 75 75 8 8 8 8 8 8 8 8 8 8 8 8 8 8 
8 8 8 8 8 75 75 1 1 1 75 75 8 8 8 8 8 8 75 1 1 1 75 70 70 75 75 75 75 75 75 75 75 75 75 75 8 8 8 8 8 8 8 8 8 8 8 8 8 8 
8 8 8 8 8 75 75 1 1 1 75 75 8 8 8 8 8 8 75 1 1 1 75 75 75 75 75 75 75 75 60 32 75 75 75 8 8 8 8 8 8 8 8 8 8 8 8 8 8 8 
8 8 8 8 8 75 75 1 1 1 75 75 8 8 8 8 8 8 75 1 1 1 75 75 29 30 30 30 31 75 32 60 75 75 75 8 75 75 75 75 75 75 8 8 8 8 8 8 8 8 
8 8 8 8 8 75 75 1 1 1 8 75 8 8 8 8 8 8 75 1 1 1 75 75 41 84 42 84 43 75 75 75 75 75 75 8 32 135 136 84 13 15 8 8 8 8 8 8 8 8 
8 8 8 8 8 75 75 1 1 1 8 8 8 8 8 8 8 8 75 1 1 1 75 75 41 60 42 60 43 75 75 75 75 75 76 8 84 139 140 32 18 20 8 8 8 8 8 8 8 8 
8 8 8 8 8 75 75 1 1 1 75 8 8 8 8 8 8 8 75 1 1 1 75 75 49 50 50 50 51 75 75 75 75 75 75 8 75 75 75 75 75 75 8 8 8 8 8 8 8 8 
8 8 8 8 8 75 75 1 1 1 75 8 8 8 8 8 8 75 75 1 1 1 75 75 75 75 75 75 75 8 75 75 75 75 75 8 1 1 1 1 75 75 75 75 75 8 8 8 8 8 
8 8 8 8 8 75 75 1 1 1 75 8 8 8 8 8 75 75 75 1 1 1 75 75 75 75 75 75 75 8 75 89 90 90 91 75 1 1 1 1 75 75 75 75 75 8 8 8 8 8 
8 8 8 8 8 75 75 1 1 1 75 8 8 8 8 75 75 70 75 1 1 1 75 70 69 75 75 75 75 8 75 89 90 90 91 75 1 1 1 1 75 70 70 70 75 8 8 8 8 8 
8 8 8 8 8 75 75 1 1 1 75 8 8 8 8 75 70 70 75 1 1 1 75 69 70 75 75 75 75 8 75 89 90 90 91 75 1 1 1 1 75 70 69 70 75 8 8 8 8 8 
8 8 8 8 8 75 75 1 1 1 75 8 8 8 75 69 75 70 75 1 1 1 75 75 8 8 8 8 8 8 75 89 90 90 91 75 1 47 48 1 75 70 70 70 75 8 8 8 8 8 
8 8 8 8 8 75 75 1 1 1 8 8 8 8 75 75 75 75 75 7 12 1 75 75 8 8 8 8 8 75 75 96 90 90 95 75 1 55 56 1 75 75 75 75 75 8 8 8 8 8 
8 8 8 8 8 75 75 1 1 1 75 75 75 8 75 8 8 75 75 33 34 1 1 1 1 1 1 1 1 1 1 1 1 1 1 1 1 1 1 1 75 75 75 75 75 8 8 8 8 8 
8 8 8 8 8 75 75 1 1 1 1 1 1 1 1 1 1 1 1 1 1 1 1 1 1 1 1 1 1 1 1 1 1 1 1 1 1 1 1 1 75 75 76 75 75 8 8 8 8 8 
8 8 8 8 8 75 75 1 1 1 1 1 1 1 1 1 1 1 1 1 1 1 1 75 75 75 75 75 75 75 75 75 75 75 75 75 75 75 75 75 75 75 75 75 75 8 8 8 8 8 
8 8 8 8 8 75 75 75 75 75 75 1 1 1 75 75 75 75 75 89 90 90 90 91 75 76 75 75 65 66 67 75 75 75 75 75 75 75 75 92 75 75 75 84 75 8 8 8 8 8 
8 8 8 8 8 75 75 75 8 8 75 1 1 1 75 75 75 60 84 89 90 90 90 91 75 75 44 75 75 75 75 84 84 75 75 75 75 75 75 75 75 84 44 75 75 8 8 8 8 8 
8 8 8 8 8 75 75 75 8 8 75 1 1 1 75 75 92 75 75 89 90 90 90 91 75 75 75 75 75 75 75 75 75 75 75 65 66 67 75 76 75 75 75 75 75 8 8 8 8 8 
8 8 8 8 8 75 75 75 75 75 75 7 12 1 75 75 8 8 75 89 90 90 90 8 8 8 8 8 8 8 8 8 8 8 75 75 75 75 75 75 75 75 75 75 75 8 8 8 8 8 
8 8 8 8 8 75 75 75 75 75 75 33 34 1 75 75 8 8 8 89 90 90 90 1 1 1 1 1 1 1 1 1 8 8 75 75 75 75 75 75 69 75 92 75 70 8 8 8 8 8 
8 8 8 8 8 75 75 44 76 75 75 1 1 1 8 75 8 8 8 8 90 90 90 1 1 1 1 1 1 1 1 1 8 8 75 75 75 75 84 13 14 14 14 15 60 8 8 8 8 8 
8 8 8 8 8 75 75 76 92 75 8 1 1 1 75 8 8 8 8 8 90 90 90 1 1 1 1 1 1 1 1 1 8 8 75 75 75 75 44 16 11 11 11 17 75 8 8 8 8 8 
8 8 8 8 8 75 75 75 75 75 75 1 1 1 75 75 75 75 75 89 90 90 90 91 70 69 75 75 75 75 75 8 8 8 75 75 75 75 75 16 11 11 11 17 69 8 8 8 8 8 
8 8 8 8 8 75 75 8 8 75 75 1 1 1 75 75 75 75 75 89 90 90 90 91 75 75 75 47 48 75 70 75 8 8 75 75 75 75 70 18 19 19 19 20 75 8 8 8 8 8 
8 8 8 8 8 75 75 75 8 8 75 1 1 1 75 75 75 75 75 89 90 90 90 91 75 75 69 55 56 75 75 75 8 8 75 75 75 75 75 60 75 75 84 44 75 8 8 8 8 8 
8 8 8 8 8 75 75 75 8 75 75 1 1 1 13 15 90 90 90 90 90 90 90 1 1 1 1 1 1 1 1 1 75 75 75 75 75 75 75 75 75 75 75 75 75 8 8 8 8 8 
8 8 8 8 8 75 75 75 75 75 75 1 1 1 18 20 90 90 90 90 90 90 90 1 1 1 1 1 1 1 1 1 75 75 8 75 75 75 75 75 75 75 75 75 75 8 8 8 8 8 
8 8 8 8 8 75 75 75 75 75 75 1 1 1 75 75 75 75 75 75 75 75 75 1 1 1 1 1 1 1 1 1 75 75 32 71 60 75 75 84 71 32 75 75 60 8 8 8 8 8 
8 8 8 8 8 75 75 75 75 75 75 75 75 75 75 75 75 75 75 75 84 32 60 75 75 75 75 75 8 8 8 8 135 136 84 71 32 133 134 60 71 84 135 136 32 8 8 8 8 8 
8 8 8 8 8 75 75 75 75 75 75 75 75 75 75 75 75 75 75 75 75 75 75 75 75 75 75 75 8 8 8 8 139 140 60 71 84 137 138 32 71 60 139 140 84 8 8 8 8 8 
8 8 8 8 8 8 8 8 8 8 8 8 8 8 8 8 8 8 8 8 8 8 8 8 8 8 8 8 8 8 8 8 8 8 8 8 8 8 8 8 8 8 8 8 8 8 8 8 8 8 
8 8 8 8 8 8 8 8 8 8 8 8 8 8 8 8 8 8 8 8 8 8 8 8 8 8 8 8 8 8 8 8 8 8 8 8 8 8 8 8 8 8 8 8 8 8 8 8 8 8 
8 8 8 8 8 8 8 8 8 8 8 8 8 8 8 8 8 8 8 8 8 8 8 8 8 8 8 8 8 8 8 8 8 8 8 8 8 8 8 8 8 8 8 8 8 8 8 8 8 8 
8 8 8 8 8 8 8 8 8 8 8 8 8 8 8 8 8 8 8 8 8 8 8 8 8 8 8 8 8 8 8 8 8 8 8 8 8 8 8 8 8 8 8 8 8 8 8 8 8 8 
8 8 8 8 8 8 8 8 8 8 8 8 8 8 8 8 8 8 8 8 8 8 8 8 8 8 8 8 8 8 8 8 8 8 8 8 8 8 8 8 8 8 8 8 8 8 8 8 8 8 
